BER	= "countries/BER - Berlin.txt"
KYB	= "countries/KYB - Kyber Collective.txt"
VIN = "countries/VIN - Vignobles.txt"
COR = "countries/COR - Corsican Papacy.txt"
ROM = "countries/ROM - Holy See.txt"
ATO = "countries/ATO - Red Circle.txt"
RAT = "countries/RAT - New Paris.txt"
OHM = "countries/OHM - Cult of Ohm.txt"
STD = "countries/STD - Der St√§dtebund.txt"
COL = "countries/COL - The Corelands.txt"
JAK = "countries/JAK - Jakobs Raubritter.txt"
RUK = "countries/RUK - Rheinuferkoalition.txt"
FRI = "countries/FRI - Freistaat.txt"
WAF = "countries/WAF - Waffenruhe.txt"
UWF = "countrues/UWF - US War Factory.txt"
SSL = "countries/SSL - Southern Sudetenland.txt"
ALE = "countries/ALE - AstroLog Enterprises.txt"
CHU = "countries/CHU - Church of Nine.txt"
NAZ = "countries/NAZ - Sturmfront.txt"
SWC = "countries/SWC - Steelweaver Commune.txt"
NOM = "countries/NOM - Northmen.txt"
NET = "countries/NET - The Nether.txt"
RED = "countries/RED - The Redacted.txt"
VEG = "countries/VEG - The New Way.txt"
BRI = "countries/BRI - Brittany.txt"
NRM = "countries/NRM - Duchy Of Normandy.txt"
UIS = "countries/UIS - Keeper Of Uhaisah.txt"
DRU = "countries/DRU - Druidic Confederation.txt"
DVK = "countries/DVK - Dannevirke.txt"
FRE = "countries/FRE - Free Poznan.txt"
COE = "countries/COE - Essen Commune.txt"
PCO = "countries/PCO - Phrygian Collective"
MPC = "countries/MPC - IG Maul"
VLC = "countries/VLC - Venlo_Compact"
UFS = "countries/UFS - United_Frisian_States"
LAT = "countries/LAT - Latium Kingdom.txt"
BYN = "countries/BYN - Byzantion.txt"
BLU = "countries/BLU - Blue Knights.txt"
ATH = "countries/ATH - Athenai.txt"
CRO = "countries/CRO - Crimson Order.txt"
HEL = "countries/HEL - Depths of Hel.txt"
SOR = "countries/SOR - Sorbs.txt"
BLP = "countries/BLP - Bloodpact.txt"
SGG = "countries/SGG - SanguineGuard.txt"
MPR = "countries/MPR - MoravianProtectorate.txt"
LRC = "countries/LRC - LegioCzeckia.txt"
THB = "countries/THB - ThousandBanners.txt"
CDA = "countries/CDA - CivicDefenseAlliance.txt"
THI = "countries/THI - TheHigh.txt"
OWG = "countries/OWG - The Overgrowth.txt"
VRD = "countries/VRD - No Man's Land.txt"
RHW = "countries/RHW - Rhinewache.txt"
RRC = "countries/RRC - Rhine River Company.txt"
SLD = "countries/SLD - Saar Duchy.txt"
STR = "countries/STR - The Southern Republic.txt"
FUL = "countries/FUL - Fuldasbairn.txt"
KAS = "countries/KAS - Kasslers.txt"
KWH = "countries/KWH - Witchhunters.txt"
LOR = "countries/LOR - The King's Grenadiers.txt"
BAT = "countries/BAT - Battered Cavalry.txt"
VER = "countries/VER - Les Versaillais.txt"
PAR = "countries/PAR - Paris Catacombs.txt"
RAB = "countries/RAB - The Rabid Wastes.txt"
PLF = "countries/PLF - Paris Liberation Front.txt"
SHB = "countries/SHB - Die Schweigenden Braunen.txt"
FIS = "countries/FIS - Fishmongers.txt"
HAL = "countries/HAL - Halle Autonomous Region.txt"
FOT = "countries/FOT - The Footmen.txt"
SIC = "countries/SIC - Regno libero di Sicilia.txt"
TUN = "countries/TUN - Colonia Tunisina.txt"
BRA = "countries/BRA - Brabant Commonwealth.txt"
HOK = "countries/HOK - Hook Tribe.txt"
WAL = "countries/WAL - United Duchies of Wallonia.txt"
LUX = "countries/LUX - Free City of Luxembourg.txt"
CHA = "countries/CHA - The Challengers.txt"
QUA = "countries/QUA - Quantum Casters.txt"
HOR = "countries/HOR - Horned Scavengers.txt"
CLD = "countries/CLD - Knightdom of Cloud.txt"
LOC = "countries/LOC - Lost Colonies.txt"
LIE = "countries/LIE - Liechtenstein.txt"
FCA = "countries/FCA - Free Cantons.txt"
OSV = "countries/OSV - Order of Saint Vitus.txt"
AKN = "countries/AKN - Aelia Knights.txt"
KMG = "countries/KMG - Kaphtor Merchant Guild.txt"
KER = "countries/KER - Kreten Republic.txt"